あかどら	赤ドラ	名詞
あがりはい	アガリ牌	名詞
あがりほうき	アガリ放棄	名詞
あがりやめ	アガリ止め	名詞
あがりれんちゃん	アガリ連荘	名詞
あしどめりーち	足止めリーチ	名詞
あたまはね	頭ハネ	名詞
あたりはい	当たり牌	名詞
あとづけ	後付け	名詞
あんかん	暗カン	名詞
あんこ	暗刻	名詞
あんぜんぱい	安全牌	名詞
あんぱい	安牌	名詞
いーしゃんてん	一向聴	名詞
いーぺーこー	イーペーコー	名詞
いーぺーこー	一盃口	名詞
いちどぶり	一度振り	名詞
いちなき	一鳴き	名詞
いちまんてんぼう	一万点棒	名詞
いっきつうかん	一気通貫	名詞
いっしょくて	一色手	名詞
いっつー	イッツー	名詞
いっつー	一通	名詞
いっぱつ	一発	名詞
いっぱつけし	一発消し	名詞
いりめ	入り目	名詞
いろよみ	色読み	名詞
うきはい	浮き牌	名詞
うちすじ	打ち筋	名詞
うま	ウマ	名詞
うらすじ	裏スジ	名詞
うらどら	裏ドラ	名詞
うらめ	裏目	名詞
うわづも	上ヅモ	名詞
うわやま	上山	名詞
おーぷんりーち	オープンリーチ	名詞
おーらす	オーラス	名詞
おか	オカ	名詞
おくりかん	送りカン	名詞
おたかぜ	オタ風	名詞
おなてん	同テン	名詞
おやおち	親落ち	名詞
おやかぶり	親カブリ	名詞
おやぎめ	親決め	名詞
おやながれ	親流れ	名詞
おり	オリ	名詞
おりうち	オリ打ち	名詞
かかん	加カン	名詞
かずはい	数牌	名詞
かぜはい	風牌	名詞
かぞえやくまん	数え役満	名詞
かたあがり	片アガリ	名詞
かぶる	カブる	名詞
かべ	カベ	名詞
かみちゃ	上家	名詞
かみちゃどり	上家取り	名詞
からぎり	空切り	名詞
からてん	空テン	名詞
かりかりとん	仮々東	名詞
かりてん	仮テン	名詞
かりとん	仮東	名詞
かん	カン	名詞
かんうら	カンウラ	名詞
かんざい	カン材	名詞
かんさき	完先	名詞
かんせいめんつ	完成メンツ	名詞
かんちゃん	カンチャン	名詞
かんつ	カンツ	名詞
かんどら	カンドラ	名詞
きーぱい	キー牌	名詞
きけんはい	危険牌	名詞
きゃくふうはい	客風牌	名詞
きゅうしゅきゅうはい	九種九牌	名詞
きゅうめんちゃん	九面張	名詞
きょうぎまーじゃん	競技麻雀	名詞
きょうたく	供託	名詞
きんだいまーじゃん	近代麻雀	固有名詞
きんま	近麻	固有名詞
くいかえ	喰い替え	名詞
くいさがり	喰い下がり	名詞
くいたん	喰いタン	名詞
くいとる	喰い取る	名詞
くいながし	喰い流し	名詞
くいながれ	喰い流れ	名詞
くいのばし	喰い伸ばし	名詞
くうかん	空カン	名詞
くうこうい	空行為	名詞
くうちー	空チー	名詞
くうぽん	空ポン	名詞
くうろん	空ロン	名詞
ぐけい	愚形	名詞
くずて	クズ手	名詞
くだりぽん	下りポン	名詞
くっつきてんぱい	くっつきテンパイ	名詞
くろぼう	黒棒	名詞
くろぼうさ	黒棒差	名詞
けいしきてんぱい	形式テンパイ	名詞
けーてん	形テン	名詞
げんばり	現張り	名詞
げんぶつ	現物	名詞
こうけい	好形	名詞
こーつ	コーツ	名詞
こくし	国士	名詞
こくしむそう	国士無双	名詞
ごせんてんぼう	五千点棒	名詞
ごつも	誤ツモ	名詞
こてがえし	小手返し	名詞
こば	小場	名詞
ごひゃくてんぼう	五百点棒	名詞
ごめんちゃん	五面張	名詞
こりつはい	孤立牌	名詞
ごろん	誤ロン	名詞
さいふ	採譜	名詞
さきぎり	先切り	名詞
さんあんこう	三暗刻	名詞
さんかんつ	三槓子	名詞
さんげんぱい	三元牌	名詞
さんしゃんてん	三向聴	名詞
さんしょうどうこう	三色同刻	名詞
さんしょくどうじゅん	三色同順	名詞
さんちゃ	散家	名詞
さんちゃくめ	三着目	名詞
さんちゃほー	三家和	名詞
さんばいまん	三倍満	名詞
さんめんちゃん	三面張	名詞
しーぱい	洗牌	名詞
じかぜ	自風	名詞
じごくたんき	地獄単騎	名詞
じごくまち	地獄待ち	名詞
しずみうま	沈みウマ	名詞
したづも	下ヅモ	名詞
したやま	下山	名詞
じどうたく	自動卓	名詞
しにめんつ	死にメンツ	名詞
じはい	字牌	名詞
しばぼう	シバ棒	名詞
しもちゃ	下家	名詞
しゃーちゃ	西家	名詞
しゃーにゅう	西入	名詞
しゃぼ	シャボ	名詞
じゃまぽん	邪魔ポン	名詞
じゃんそう	雀荘	名詞
じゃんたく	雀卓	名詞
しゃんてん	向聴	名詞
しゃんてんすう	向聴数	名詞
しゃんてんもどし	向聴戻し	名詞
じゃんぷう	雀風	名詞
しゃんぽん	シャンポン	名詞
しゃんぽんまち	シャンポン待ち	名詞
じゃんりょく	雀力	名詞
じゃんれき	雀歴	名詞
じゅうさんめんちゃん	十三面張	名詞
しゅーぱい	数牌	名詞
じゅうぶんけい	十分形	名詞
じゅんいうま	順位ウマ	名詞
じゅんから	純カラ	名詞
じゅんちゃん	純チャン	名詞
しゅんつ	シュンツ	名詞
じゅんめ	巡目	名詞
しょうさんげん	小三元	名詞
しょうすうし	小四喜	名詞
しょうはい	少牌	名詞
しょんぱい	生牌	名詞
すーあんこう	四暗刻	名詞
すーかいかん	四開槓	名詞
すーかんつ	四槓子	名詞
すうぱい	数牌	名詞
すーふーれんだ	四風連打	名詞
すじ	スジ	名詞
すじひっかけ	スジ引っかけ	名詞
すったん	スッタン	名詞
すてはい	捨牌	名詞
すてはいそう	捨牌相	名詞
せきにんばらい	責任払い	名詞
せっとじゃんそう	セット雀荘	名詞
せんげんはい	宣言牌	名詞
ぜんじどうまーじゃんたく	全自動麻雀卓	名詞
ぜんたいやく	全体役	名詞
せんちゃんぱい	尖張牌	名詞
ぜんつ	ゼンツ	名詞
ぜんつっぱ	全ツッパ	名詞
せんてんぼう	千点棒	名詞
せんぱい	洗牌	名詞
せんぱい	尖牌	名詞
そうず	ソウズ	名詞
そうちゃ	荘家	名詞
そくりー	即リー	名詞
そくりーち	即リーチ	名詞
そばてん	ソバテン	名詞
そめて	染め手	名詞
たーちゃ	他家	名詞
たーつ	ターツ	名詞
たーはい	多牌	名詞
だいさんげん	大三元	名詞
だいすうし	大四喜	名詞
だいみんかん	大明カン	名詞
たおぱい	倒牌	名詞
たかめ	高目	名詞
たくそう	卓掃	名詞
たくわれ	卓割れ	名詞
たけしょぼう	竹書房	固有名詞
だはい	打牌	名詞
だぶどら	ダブドラ	名詞
だぶるばっく	ダブルパック	名詞
だぶるやくまん	ダブル役満	名詞
だぶるりーち	ダブルリーチ	名詞
だぶろん	ダブロン	名詞
だまてん	ダマテン	名詞
ためんちゃん	多面張	名詞
だんとつ	ダントツ	名詞
たんぱい	タンパイ	名詞
たんやお	タンヤオ	名詞
だんらす	ダンラス	名詞
ちー	チー	名詞
ちーちゃ	起家	名詞
ちーちゃまーく	起家マーク	名詞
ちーてん	チーテン	名詞
ちーといつ	七対子	名詞
ちーといつ	チートイツ	名詞
ちーほう	地和	名詞
ちゃくじゅん	着順	名詞
ちゃんかん	チャンカン	名詞
ちゃんた	チャンタ	名詞
ちゃんちゃ	荘家	名詞
ちゅうちゃんぱい	中張牌	名詞
ちゅうれんぽうとう	九蓮宝燈	名詞
ちょんぼ	チョンボ	名詞
ちんいつ	チンイツ	名詞
ちんいつ	清一色	名詞
ちんろうとう	清老頭	名詞
つーいーそー	字一色	名詞
つーぱい	字牌	名詞
つかみどり	つかみ取り	名詞
つみぼう	積み棒	名詞
つも	ツモ	名詞
つもあがり	ツモアガリ	名詞
つもぎり	ツモ切り	名詞
つもじゅん	ツモ順	名詞
つもすー	ツモスー	名詞
つもすじ	ツモ筋	名詞
つもはい	ツモ牌	名詞
つもばん	ツモ番	名詞
つもふ	ツモ符	名詞
つもやま	ツモ山	名詞
つもりさんあんこう	ツモリ三暗刻	名詞
つもりすーあんこう	ツモり四暗刻	名詞
でおや	出親	名詞
てがわり	手変わり	名詞
できめんつ	出来メンツ	名詞
てだし	手出し	名詞
てつまん	徹マン	名詞
てづみ	手積み	名詞
てなり	手なり	名詞
てはい	手牌	名詞
でばさい	デバサイ	名詞
てやくは	手役派	名詞
てんぱいけい	テンパイ形	名詞
てんぱいやめ	テンパイ止め	名詞
てんぱいれんちゃん	テンパイ連荘	名詞
てんぱね	テンパネ	名詞
てんほう	天和	名詞
てんぼう	点棒	名詞
といつ	トイツ	名詞
といつおとし	トイツ落とし	名詞
といつば	トイツ場	名詞
といとい	トイトイ	名詞
といといほー	対々和	名詞
といめん	対面	名詞
とうはい	闘牌	名詞
とうぱい	倒牌	名詞
どたかめ	ド高目	名詞
とっぷどり	トップ取り	名詞
とっぷめ	トップ目	名詞
とび	トビ	名詞
とびすん	トビ寸	名詞
どぼん	ドボン	名詞
どやすめ	ド安目	名詞
どら	ドラ	名詞
どらうけ	ドラ受け	名詞
どらすじ	ドラ筋	名詞
どらそば	ドラソバ	名詞
どらたん	ドラ単	名詞
どらひょう	ドラ表	名詞
どらまたぎ	ドラまたぎ	名詞
とりぷるとん	トリプルロン	名詞
とりぷるやくまん	トリプル役満	名詞
とりぷるろん	トリプルロン	名詞
とりろん	トリロン	名詞
とん	幢	名詞
とんちゃ	東家	名詞
とんなんせん	東南戦	名詞
とんぱつ	東パツ	名詞
とんぷうせん	東風戦	名詞
とんらす	東ラス	名詞
ながしまんがん	流し満貫	名詞
なかぬき	中抜き	名詞
なかぶくれ	中ぶくれ	名詞
なきまーじゃん	鳴き麻雀	名詞
ななめんちゃん	七面張	名詞
なにきる	何切る	名詞
なんちゃ	南家	名詞
なんにゅう	南入	名詞
にちゃくめ	二着目	名詞
にどうけ	二度受け	名詞
にどぶり	二度振り	名詞
になき	二鳴き	名詞
ぬけばん	抜け番	名詞
ねっとまーじゃん	ネット麻雀	名詞
ねとま	ネト麻	名詞
のーちゃんす	ノーチャンス	名詞
のーてん	ノーテン	名詞
のーてんばっぷ	ノーテン罰符	名詞
のーほーら	ノーホーラ	名詞
のべたん	ノベタン	名詞
のみて	ノミ手	名詞
ぱーれんちゃん	八連荘	名詞
はいきゅうげんてん	配給原点	名詞
はいこうりつ	牌効率	名詞
はいさばき	牌捌き	名詞
はいし	牌姿	名詞
ばいちょく	倍直	名詞
ばいつも	倍ツモ	名詞
はいてい	ハイテイ	名詞
はいぱい	配牌	名詞
はいふ	牌譜	名詞
ぱいふ	牌譜	名詞
ばいまん	倍満	名詞
はいやま	牌山	名詞
はいり	牌理	名詞
はいりめ	入り目	名詞
ぱお	パオ	名詞
ばかぜ	場風	名詞
ばきょう	場況	名詞
はこてん	ハコテン	名詞
はしはい	端牌	名詞
ばぞろ	場ゾロ	名詞
ばだい	場代	名詞
はだかたんき	裸単騎	名詞
はちめんちゃん	八面張	名詞
ばっぷ	罰符	名詞
はなはい	花牌	名詞
はねちょく	ハネ直	名詞
はねつも	ハネツモ	名詞
はねまん	ハネ満	名詞
はん	ハン	名詞
はんちゃん	半荘	名詞
ひきづも	引きヅモ	名詞
ひゃくてんぼう	百点棒	名詞
ひょうじはい	表示牌	名詞
ひらば	平場	名詞
ぴんず	ピンズ	名詞
ぴんふ	ピンフ	名詞
ふぁん	翻	名詞
ふーてい	副底	名詞
ふーろ	副露	名詞
ふせはい	伏せ牌	名詞
ふはね	符ハネ	名詞
ぶぶんやく	部分役	名詞
ふりーじゃんそう	フリー雀荘	名詞
ふりてん	フリテン	名詞
ぺーちゃ	北家	名詞
べたおり	ベタオリ	名詞
ぺんちゃん	ペンチャン	名詞
ほうじゅう	放銃	名詞
ほうてい	ホウテイ	名詞
ぼうてん	棒テン	名詞
ぼうはい	暴牌	名詞
ほーら	和了	名詞
ぽん	ポン	名詞
ほんいつ	ホンイツ	名詞
ほんいつ	混一色	名詞
ぽんかす	ポンカス	名詞
ぽんざい	ポン材	名詞
ぽんてん	ポンテン	名詞
ほんば	本場	名詞
ほんろうとう	混老頭	名詞
まーじゃんかん	麻雀観	名詞
まーじゃんぱい	麻雀牌	名詞
まーじゃんれき	麻雀歴	名詞
またぎすじ	またぎスジ	名詞
まちどり	待ち取り	名詞
まちはい	待ち牌	名詞
まちよみ	待ち読み	名詞
まわしうち	回し打ち	名詞
まわりおや	回り親	名詞
まんがん	満貫	名詞
まんず	マンズ	名詞
まんちょく	満直	名詞
まんつも	満ツモ	名詞
みせはい	見せ牌	名詞
みんかん	明カン	名詞
むすじ	無スジ	名詞
むだづも	無駄ヅモ	名詞
めんぜん	メンゼン	名詞
めんたんぴん	メンタンピン	名詞
めんちん	メンチン	名詞
めんつ	メンツ	名詞
めんぴん	メンピン	名詞
めんほん	メンホン	名詞
もうぱい	盲牌	名詞
もーた	摸打	名詞
もちもち	モチモチ	名詞
もろひ	モロヒ	名詞
もろひっかけ	モロ引っかけ	名詞
やおちゅーはい	?九牌	名詞
やきとり	ヤキトリ	名詞
やくなし	役無し	名詞
やくはい	役牌	名詞
やくまん	役満	名詞
やすめ	安目	名詞
やまよみ	山読み	名詞
ゆうこうはい	有効牌	名詞
よじょうはい	余剰牌	名詞
よにんりーち	四人立直	名詞
よんちゃくめ	四着目	名詞
よんめんちゃん	四面張	名詞
らす	ラス	名詞
らすあがり	ラスアガリ	名詞
らすおち	ラス落ち	名詞
らすおや	ラス親	名詞
らすぬけ	ラス抜け	名詞
らすはい	ラス牌	名詞
らすまえ	ラス前	名詞
らすめ	ラス目	名詞
りあま	リア麻	名詞
りあるまーじゃん	リアル麻雀	名詞
りーち	リーチ	名詞
りーちしゃ	リーチ者	名詞
りーはい	理牌	名詞
りゃんかん	リャンカン	名詞
りゃんしゃんてん	二向聴	名詞
りゃんはんしばり	二翻縛り	名詞
りゃんぺーこー	二盃口	名詞
りゃんぺーこー	リャンペーコー	名詞
りゃんめん	両面	名詞
りゃんめん	リャンメン	名詞
りゅーいーそー	緑一色	名詞
りゅうきょく	流局	名詞
りゅーふぁ	緑發	名詞
りょうけい	良形	名詞
りょうてんびん	両天秤	名詞
りんしゃん	リンシャン	名詞
りんしゃんかいほう	嶺上開花	名詞
りんしゃんぱい	リンシャン牌	名詞
りんぱい	零牌	名詞
れんちゃん	連荘	名詞
れんぷうはい	連風牌	名詞
れんほう	人和	名詞
ろうとうはい	老頭牌	名詞
ろくめんちゃん	六面張	名詞
ろん	ロン	名詞
ろんあがり	ロンアガリ	名詞
わんちゃんす	ワンチャンス	名詞
わんぱい	王牌	名詞	