あいさわ	相沢	姓	
あいさわかおる	相沢かおる	人名	
あおい	蒼井	姓	
あおい	葵	人名	
あおいゆりか	蒼井ゆりか	人名	
あおき	蒼木	姓	
あおきしょうこ	蒼木翔子	人名	
あおやま	蒼山	姓	
あおやま	青山	姓	
あおやましゅうすけ	蒼山秀佑	人名	
あおやまめぐみ	青山めぐみ	人名	
あかし	明石	姓	
あかし	赤司	姓	
あかしていか	明石定家	人名	
あかしみなこ	赤司美奈子	人名	
あき	亜樹	人名	
あきお	章生	人名	
あきのり	亮典	人名	
あきひこ	昭彦	人名	
あきひこ	明彦	人名	
あきひろ	彰宏	人名	
あきひろ	明広	人名	
あきら	朗	人名	
あきら	晶	人名	
あくつ	阿久津	姓	
あくつしょうた	阿久津翔太	人名	
あさい	朝井	姓	
あさいひろよし	朝井大元	人名	
あさみ	亜沙己	人名	
あずま	東	姓	
あずまこういちろう	東幸一郎	人名	
あたらし	新	姓	
あたらしだいち	新大地	人名	
あつし	篤史	人名	
あつし	惇	人名	
あつし	敦志	人名	
あづま	吾妻	姓	
あづまさおり	吾妻さおり	人名	
あつや	厚谷	姓	
あつやしょうた	厚谷昇汰	人名	
あべ	阿部	姓	
あべ	安部	姓	
あべけんいち	阿部謙一	人名	
あべはやと	安部颯斗	人名	
あやか	彩夏	人名	
あやか	彩花	人名	
あやの	彩乃	人名	
あゆかわ	鮎川	姓	
あゆかわたく	鮎川卓	人名	
あゆむ	歩	人名	
あら	荒	姓	
あらい	新井	姓	
あらい	荒井	姓	
あらいしゅんいち	新井駿一	人名	
あらいりょうた	荒井伶太	人名	
あらまき	荒牧	姓	
あらまきふゆき	荒牧冬樹	人名	
あらまさよし	荒正義	人名	
ありさ	朱里紗	人名	
ありた	有田	姓	
ありたまさゆき	有田将之	人名	
あん	安	姓	
あんどう	安藤	姓	
あんどうりな	安藤りな	人名	
あんぴょんさん	安秉参	人名	
いい	伊井	姓	
いいくうが	伊井功雅	人名	
いいちろう	威一郎	人名	
いが	伊賀	姓	
いがのりお	伊賀則夫	人名	
いくお	育夫	人名	
いけだ	池田	姓	
いけだらいと	池田来斗	人名	
いさか	井坂	姓	
いさかあきひろ	井坂彰宏	人名	
いさむ	勇	人名	
いしかわ	石川	姓	
いしかわごうし	石川豪士	人名	
いしかわしま	石川詩万	人名	
いしかわまさあき	石川正明	人名	
いしかわりょう	石川遼	人名	
いしだ	石田	姓	
いしだあさみ	石田亜沙己	人名	
いしだて	石立	姓	
いしだてたけひろ	石立岳大	人名	
いしだゆうき	石田優輝	人名	
いしばし	石橋	姓	
いしばしかずや	石橋和也	人名	
いしはら	石原	姓	
いしはらやすのぶ	石原康申	人名	
いしわた	石渡	姓	
いしわたまさし	石渡正志	人名	
いずみ	泉	姓	
いずみ	和泉	姓	
いずみゆうと	泉裕斗	人名	
いずみゆきこ	和泉由希子	人名	
いずみりょうた	泉亮多	人名	
いちのせ	一瀬	姓	
いちのせゆり	一瀬由梨	人名	
いつき	一樹	人名	
いで	井出	姓	
いでかずのり	井出一寛	人名	
いでこうへい	井出康平	人名	
いとう	居藤	姓	
いとう	伊藤	姓	
いとうこう	居藤洸	人名	
いとうだいすけ	伊藤大輔	人名	
いとうてつや	伊藤鉄也	人名	
いとうゆうこう	伊藤優孝	人名	
いなおか	稲岡	姓	
いなおかみか	稲岡ミカ	人名	
いぬみ	犬見	姓	
いぬみたけし	犬見武史	人名	
いの	井野	姓	
いのあおい	井野葵	人名	
いのうえ	井上	姓	
いのうええみこ	井上絵美子	人名	
いのうえなおゆき	井上真孝	人名	
いのうえやすひで	井上泰秀	人名	
いまいずみ	今泉	姓	
いまいずみせいいち	今泉誠一	人名	
いまおか	今岡	姓	
いまおかひでただ	今岡英忠	人名	
いわい	岩井	姓	
いわいけんた	岩井健太	人名	
うえだ	上田	姓	
うえだなおき	上田直樹	人名	
うえだりょう	上田稜	人名	
うおたに	魚谷	姓	
うおたにゆうみ	魚谷侑未	人名	
うちかわ	内川	姓	
うちかわこうたろう	内川幸太郎	人名	
うちだ	内田	姓	
うちだみこ	内田みこ	人名	
うちだみのり	内田美乃里	人名	
うちやま	内山	姓	
うちやまあゆむ	内山歩	人名	
うちやまえみ	内山えみ	人名	
うてな	台	姓	
うてななおき	台直輝	人名	
うめなか	梅中	姓	
うめなかゆうすけ	梅中悠介	人名	
うらの	浦野	姓	
うらのしゅうへい	浦野修平	人名	
えいじ	栄二	人名	
えざき	江嵜	姓	
えざきしんのすけ	江嵜晋之介	人名	
えびはら	蛯原	姓	
えびはらあきら	蛯原朗	人名	
えみ	恵美	人名	
えみこ	絵美子	人名	
えり	絵里	人名	
えりかわ	襟川	姓	
えりかわまいこ	襟川麻衣子	人名	
おいつき	老月	姓	
おいつきたかのり	老月貴紀	人名	
おうぎだ	扇田	姓	
おうぎだひろゆき	扇田紘征	人名	
おおかぬか	大鹿糠	姓	
おおかぬかふみや	大鹿糠文也	人名	
おおがめ	大亀	姓	
おおがめあすか	大亀あすか	人名	
おおき	大木	姓	
おおきあきのり	大木亮典	人名	
おおくぼ	大久保	姓	
おおくぼともみ	大久保朋美	人名	
おおた	太田	姓	
おおたひろこ	太田寛子	人名	
おおたまさき	太田昌樹	人名	
おおたゆうすけ	太田優介	人名	
おおつき	大槻	姓	
おおつき	大月	姓	
おおつきあいみ	大槻あいみ	人名	
おおつきれみ	大月れみ	人名	
おおの	大野	姓	
おおのあやの	大野彩乃	人名	
おおば	大庭	姓	
おおばさんしろう	大庭三四郎	人名	
おおわだ	大和田	姓	
おおわだあつし	大和田篤史	人名	
おかざき	岡崎	姓	
おかざきりょうた	岡崎涼太	人名	
おがさはら	小笠原	姓	
おがさはらなお	小笠原奈央	人名	
おかだ	岡田	姓	
おかだ	小高	姓	
おかださやか	岡田紗佳	人名	
おかだしげる	岡田茂	人名	
おかだともかず	岡田智和	人名	
おかだゆうき	小高佑貴	人名	
おかべ	岡部	姓	
おかべみつてる	岡部光輝	人名	
おかもと	岡本	姓	
おかもとかずや	岡本和也	人名	
おがわ	小川	姓	
おがわじゅん	小川淳	人名	
おがわなおや	小川尚哉	人名	
おき	沖	姓	
おきひかる	沖ヒカル	人名	
おくだ	奥田	姓	
おくだゆうき	奥田裕貴	人名	
おくつ	奥津	姓	
おくつゆうき	奥津勇輝	人名	
おぐるま	小車	姓	
おぐるましょう	小車祥	人名	
おけもと	桶本	姓	
おけもとあつし	桶本篤史	人名	
おさむら	長村	姓	
おさむらだい	長村大	人名	
おだ	小田	姓	
おださとし	小田悟志	人名	
おとは	音羽	姓	
おとはなお	音羽なお	人名	
おの	小野	姓	
おのまさとし	小野雅峻	人名	
がーす	ガース	人名	
がーす	ガース	姓	
かいばら	貝原	姓	
かいばらかおる	貝原香	人名	
かおり	香織	人名	
かおる	香	人名	
かける	翔	人名	
かしま	鹿嶌	姓	
かしまぶんた	鹿嶌文太	人名	
かずのり	一寛	人名	
かずのり	和典	人名	
かずひこ	一彦	人名	
かずひろ	和宏	人名	
かずや	和也	人名	
かたくら	片倉	姓	
かたくらまち	片倉まち	人名	
かつまた	勝又	姓	
かつまたけんじ	勝又健志	人名	
かつや	勝也	人名	
かとう	加藤	姓	
かとうたかひと	加藤貴一	人名	
かどや	角谷	姓	
かどやようすけ	角谷陽介	人名	
かな	加南	人名	
かな	花奈	人名	
かねこ	金子	姓	
かねこたかゆき	金子貴行	人名	
かねこまさあき	金子正明	人名	
かみむら	上村	姓	
かみむらしんたろう	上村慎太郎	人名	
かわぐち	川口	姓	
かわぐちりょうが	川口亮雅	人名	
かわぞえ	川添	姓	
かわぞえりょうた	川添瞭太	人名	
かわはら	川原	姓	
かわはらまいこ	川原舞子	人名	
かんじょう	貫上	姓	
かんじょうひろし	貫上洋志	人名	
かんすけ	勘介	人名	
かんばやし	神林	姓	
かんばやしごう	神林剛	人名	
きくた	菊田	姓	
きくたまさとし	菊田政俊	人名	
きくはら	菊原	姓	
きくはらまさと	菊原真人	人名	
きたの	北野	姓	
きたのゆみ	北野由実	人名	
きば	木場	姓	
きばゆうじ	木場佑ニ	人名	
きはら	木原	姓	
きはらつばさ	木原翼	人名	
きもと	木本	姓	
きもとだいすけ	木本大介	人名	
きゃくの	客野	姓	
きゃくのなおき	客野直	人名	
きょうこ	京子	人名	
きょうひら	京平	姓	
きょうひらはるか	京平遥	人名	
きよはら	清原	姓	
きよはらつぐみつ	清原継光	人名	
きよみつ	清光	人名	
くうが	功雅	人名	
くしだ	櫛田	姓	
くしだとした	櫛田利太	人名	
くすはら	楠原	姓	
くすはらゆう	楠原遊	人名	
くろき	黒木	姓	
くろきまさお	黒木真生	人名	
くろさわ	黒沢	姓	
くろさわさき	黒沢咲	人名	
くろば	黒羽	姓	
くろばかける	黒羽翔	人名	
けい	慧	人名	
けいいち	圭一	人名	
けいご	敬悟	人名	
けいじ	桂史	人名	
けいじゅん	圭純	人名	
けいすけ	恵介	人名	
けねすとくだ	ケネス徳田	人名	
けねすとくだ	ケネス徳田	姓	
げん	源	姓	
けんいち	謙一	人名	
けんじ	健志	人名	
けんじろう	健二郎	人名	
げんじろう	源二郎	人名	
けんた	健太	人名	
こう	洸	人名	
ごう	剛	人名	
ごう	豪	人名	
こういちろう	幸一郎	人名	
こうき	紘己	人名	
こうき	倖輝	人名	
こうじ	浩二	人名	
こうじ	浩司	人名	
こうじ	孝次	人名	
こうじ	康次	人名	
ごうし	豪士	人名	
こうしろう	浩史郎	人名	
こうた	昴汰	人名	
こうたろう	幸太郎	人名	
こうたろう	光太郎	人名	
こうたろう	航太郎	人名	
こうの	香野	姓	
こうのすけ	皓之介	人名	
こうのらん	香野蘭	人名	
こうへい	康平	人名	
こうへい	航平	人名	
こぐれ	木暮	姓	
こぐれともき	木暮智貴	人名	
こしの	越野	姓	
こしのとものり	越野智紀	人名	
こじま	小島	姓	
こじまひろのぶ	小島広宣	人名	
こだま	小玉	姓	
こだまわたる	小玉渉	人名	
ごとう	後藤	姓	
ごとうさき	後藤咲	人名	
こばやし	小林	姓	
こばやしだいち	小林大地	人名	
こばやしまさかず	小林正和	人名	
こまだ	駒田	姓	
こまだまこ	駒田真子	人名	
こまつ	小松	姓	
こまつたけぞう	小松武蔵	人名	
こんどう	近藤	姓	
こんどうひさはる	近藤久春	人名	
こんの	紺野	姓	
こんのしんたろう	紺野真太郎	人名	
こんのみつのり	紺野光則	人名	
さいじょう	西城	姓	
さいじょうりん	西城凛	人名	
さいとう	斉藤	姓	
さいとう	齋藤	姓	
さいとうけいじ	斉藤桂史	人名	
さいとうごう	齋藤豪	人名	
さいとうまいこ	齋藤麻衣子	人名	
さいとうりえ	斉藤理絵	人名	
さおり	小緒里	人名	
さき	咲	人名	
さき	紗希	人名	
さきく	紗掬	人名	
さくら	咲良	姓	
さくらい	桜井	姓	
さくらい	櫻井	姓	
さくらいこうき	桜井紘己	人名	
さくらいひでき	櫻井秀樹	人名	
さくらいゆうま	櫻井勇馬	人名	
さくらかわ	桜川	姓	
さくらかわひめこ	桜川姫子	人名	
さくらぎ	桜木	姓	
さくらぎりさ	桜木里咲	人名	
さくらみお	咲良美緒	人名	
ささき	佐々木	姓	
ささきひさと	佐々木寿人	人名	
さだみ	貞臣	人名	
さとう	佐藤	姓	
さとうりょうた	佐藤伶太	人名	
さとき	里木	姓	
さときゆうすけ	里木祐介	人名	
さとし	悟志	人名	
さとし	聡	人名	
さとし	智	人名	
さとる	悟	人名	
さやか	紗佳	人名	
さやま	佐山	姓	
さやまりゅうすけ	佐山竜介	人名	
さるかわ	猿川	姓	
さるかわまさとし	猿川真寿	人名	
さわざき	沢崎	姓	
さわざきまこと	沢崎誠	人名	
さわだ	澤田	姓	
さわだゆい	澤田唯	人名	
さわや	澤谷	姓	
さわやりょう	澤谷諒	人名	
さんしろう	三四郎	人名	
さんぺい	三幣	姓	
さんぺいこうた	三幣昴汰	人名	
じぇん	ジェン	人名	
じぇん	ジェン	姓	
じぇんふぁん	政芳	人名	
しおり	志織	人名	
しげはら	重原	姓	
しげはらさとし	重原聡	人名	
しげる	茂	人名	
しばた	柴田	姓	
しばたこうへい	柴田航平	人名	
しばたよしかず	柴田吉和	人名	
しぶや	渋谷	姓	
しぶやなるみ	渋谷菜瑠美	人名	
しほ	志穂	人名	
しま	詩万	人名	
しまむら	嶋村	姓	
しまむらやすゆき	嶋村泰之	人名	
しみず	清水	姓	
しみずかおり	清水香織	人名	
しみずりゅういち	清水隆市	人名	
しゅうえい	秀映	人名	
しゅうじ	修二	人名	
しゅうすけ	秀佑	人名	
しゅうへい	修平	人名	
しゅん	峻	人名	
じゅん	淳	人名	
じゅん	純	人名	
しゅんいち	駿一	人名	
じゅんいちろう	潤一郎	人名	
しょう	祥	人名	
しょう	翔	人名	
しょうこ	翔子	人名	
しょうご	正悟	人名	
しょうた	翔太	人名	
しょうた	昇汰	人名	
しょうだ	庄田	姓	
しょうだゆうせい	庄田祐生	人名	
しょうへい	翔平	人名	
しょうへい	祥平	人名	
しらとり	白鳥	姓	
しらとりしょう	白鳥翔	人名	
じろう	二郎	人名	
しろがね	白銀	姓	
しろがねさき	白銀紗希	人名	
しん	信	人名	
しんいち	伸一	人名	
しんご	真吾	人名	
しんご	慎吾	人名	
しんじ	真仁	人名	
しんたに	新谷	姓	
しんたにしょうへい	新谷翔平	人名	
しんたろう	慎太郎	人名	
しんたろう	真太郎	人名	
しんのすけ	晋之介	人名	
しんや	慎也	人名	
しんや	晋也	人名	
すうら	須浦	姓	
すうらまさひろ	須浦正裕	人名	
すえつぐ	末続	姓	
すえつぐひろとし	末続ヒロトシ	人名	
すがわら	菅原	姓	
すがわらひろえ	菅原千瑛	人名	
すぎうら	杉浦	姓	
すぎうらかんすけ	杉浦勘介	人名	
すぎうらまゆ	杉浦まゆ	人名	
すぎやま	杉山	姓	
すぎやまとしひこ	杉山俊彦	人名	
すずき	鈴木	姓	
すずきあやか	鈴木彩夏	人名	
すずきひでゆき	鈴木秀幸	人名	
すずきひろあき	鈴木宏明	人名	
すずきふみたか	鈴木郁孝	人名	
すずきまこと	鈴木誠	人名	
すずきゆうすけ	鈴木雄介	人名	
すなが	須長	姓	
すながまさかず	須長正和	人名	
すやま	陶山	姓	
すやままさあき	陶山昌明	人名	
せいいち	誠一	人名	
せいいちろう	誠一郎	人名	
せきじま	関島	姓	
せきじまよしき	関島義基	人名	
せじも	瀬下	姓	
せじもかつや	瀬下勝也	人名	
せとくま	瀬戸熊	姓	
せとくまなおき	瀬戸熊直樹	人名	
そしの	曽篠	姓	
そしのはるなり	曽篠春成	人名	
だい	大	人名	
だいすけ	大輔	人名	
だいすけ	大介	人名	
だいすけ	太佑	人名	
だいち	大地	人名	
たいよう	太陽	人名	
たえこ	妙子	人名	
たかざわ	高沢	姓	
たかざわまさし	高沢雅	人名	
たかし	孝志	人名	
たかし	駿	人名	
たかし	崇志	人名	
たかせ	高瀬	姓	
たかせしょう	高瀬翔	人名	
たかた	高田	姓	
たかだ	髙田	姓	
たかだしょう	髙田翔	人名	
たかたに	高谷	姓	
たかたにけいいち	高谷圭一	人名	
たかたまいこ	高田麻衣子	人名	
たかのり	貴紀	人名	
たかのり	崇勝	人名	
たかはし	髙橋	姓	
たかはし	高橋	姓	
たかはしいさむ	髙橋勇	人名	
たかはしけい	高橋慧	人名	
たかはしだいすけ	高橋大輔	人名	
たかはしのぶお	高橋信夫	人名	
たかはしゆき	高橋侑希	人名	
たかはしりょうすけ	高橋良介	人名	
たかひと	貴一	人名	
たかひろ	隆弘	人名	
たかみや	高宮	姓	
たかみやまり	高宮まり	人名	
たかやなぎ	高柳	姓	
たかやなぎともや	高柳寛哉	人名	
たかゆき	貴行	人名	
たきざわ	滝沢	姓	
たきざわ	瀧澤	姓	
たきざわかずのり	滝沢和典	人名	
たきざわこうたろう	瀧澤光太郎	人名	
たきた	滝田	姓	
たきたなおと	滝田直大	人名	
たく	卓	人名	
たくや	卓也	人名	
たけいし	武石	姓	
たけいしえり	武石絵里	人名	
たけし	武史	人名	
たけぞう	武蔵	人名	
たけだ	武田	姓	
たけだひなほ	武田雛歩	人名	
たけだゆうき	武田裕希	人名	
たけひろ	岳大	人名	
たしろ	田代	姓	
たしろこうたろう	田代航太郎	人名	
ただし	直	人名	
たちかわ	刀川	姓	
たちかわまさひろ	刀川昌浩	人名	
たった	立田	姓	
たったしょうへい	立田祥平	人名	
たつまる	竜丸	人名	
たつや	達也	人名	
たつや	達矢	人名	
たつや	辰哉	人名	
だて	伊達	姓	
だてありさ	伊達朱里紗	人名	
たなか	田中	姓	
たなかふみたか	田中史孝	人名	
たに	谷	姓	
だにえる	ダニエル	姓	
だにえるもれの	ダニエルモレノ	人名	
たにおか	谷岡	姓	
たにおかいくお	谷岡育夫	人名	
たにまさゆき	谷誠之	人名	
だんぷおおはし	ダンプ大橋	人名	
だんぷおおはし	ダンプ大橋	姓	
ちあき	千晶	人名	
ちひろ	智寛	人名	
ちふみ	千文美	人名	
つかごし	塚越	姓	
つかごしたつや	塚越達也	人名	
つぐみつ	継光	人名	
つじもと	辻本	姓	
つじもといつき	辻本一樹	人名	
つちだ	土田	姓	
つちださおり	土田小緒里	人名	
つばさ	翼	人名	
つよし	毅	人名	
ていか	定家	人名	
てつ	徹	人名	
てづか	手塚	姓	
てづかさきく	手塚紗掬	人名	
てつや	鉄也	人名	
てつや	哲也	人名	
てらお	寺尾	姓	
てらおいいちろう	寺尾威一郎	人名	
てらど	寺戸	姓	
てらどたかし	寺戸孝志	人名	
てんね	天音	姓	
てんねまこと	天音まこと	人名	
どい	土井	姓	
どいさとる	土井悟	人名	
といだ	戸井田	姓	
といだきよみつ	戸井田清光	人名	
とうじょう	東城	姓	
とうじょうりお	東城りお	人名	
とうね	藤根	姓	
とうねりさ	藤根梨沙	人名	
とした	利太	人名	
としひこ	俊彦	人名	
としひろ	俊宏	人名	
としま	外嶋	姓	
としまりょうた	外嶋諒汰	人名	
とだ	戸田	姓	
とだまさき	戸田誠輝	人名	
とべ	戸部	姓	
とべひろつぐ	戸部弘次	人名	
とみた	冨田	姓	
とみたちひろ	冨田智寛	人名	
とみたひさし	冨田久志	人名	
ともかず	智和	人名	
ともき	智貴	人名	
ともこ	智子	人名	
ともたけまさはる	ともたけ雅晴	人名	
とものり	智紀	人名	
ともひろ	朋広	人名	
ともひろ	智博	人名	
ともみ	朋美	人名	
ともみ	知美	人名	
ともや	寛哉	人名	
とりごえ	鳥越	姓	
とりごえしんじ	鳥越真仁	人名	
とりや	部谷	姓	
とりやゆきのり	部谷幸則	人名	
とん	童	姓	
とん	瞳	人名	
とんとん	童瞳	人名	
ないとう	内藤	姓	
ないとうまさき	内藤正樹	人名	
なお	奈央	人名	
なおき	直樹	人名	
なおき	直輝	人名	
なおき	直	人名	
なおき	直毅	人名	
なおと	直大	人名	
なおや	尚哉	人名	
なおや	直哉	人名	
なおゆき	真孝	人名	
なか	中	姓	
ながい	永井	姓	
ながい	長井	姓	
ながいたくや	永井卓也	人名	
ながいまさはる	永井勝晴	人名	
ながいりせ	長井梨世	人名	
なかがわ	中川	姓	
ながかわ	永川	姓	
ながかわしゅうえい	永川秀映	人名	
なかがわもとき	中川基輝	人名	
なかがわゆかり	中川由佳梨	人名	
なかぐき	中岫	姓	
なかぐきひろぶみ	中岫宏文	人名	
なかた	仲田	姓	
なかだ	中田	姓	
なかだ	仲田	姓	
なかたかな	仲田加南	人名	
なかだかな	中田花奈	人名	
なかだこうじ	仲田浩二	人名	
なかつ	中津	姓	
なかつしんご	中津真吾	人名	
なかつち	中土	姓	
なかつちけいすけ	中土恵介	人名	
なかにし	中西	姓	
なかにしえいじ	中西栄二	人名	
なかの	中野	姓	
なかのたえこ	中野妙子	人名	
なかののぶすけ	中野暢介	人名	
なかひさふみ	中寿文	人名	
なかひら	中平	姓	
なかひらゆうすけ	中平優佑	人名	
なかむら	中村	姓	
なかむらしんご	中村慎吾	人名	
なかむらつよし	中村毅	人名	
なかむらふみや	中村文哉	人名	
なかやま	中山	姓	
なかやまななみ	中山奈々美	人名	
なぎ	梛木	姓	
なぎひろのぶ	梛木広信	人名	
なつめ	夏目	姓	
なつめみどり	夏目翠	人名	
ななみ	奈々美	人名	
なら	奈良	姓	
ならけいじゅん	奈良圭純	人名	
なるみ	菜瑠美	人名	
なんり	南里	姓	
なんりはるみ	南里はるみ	人名	
にかいどう	二階堂	姓	
にかいどうあき	二階堂亜樹	人名	
にかいどうるみ	二階堂瑠美	人名	
にしおか	西岡	姓	
にしおかのりやす	西岡慎泰	人名	
にしかわ	西川	姓	
にしかわじゅん	西川淳	人名	
にしじま	西島	姓	
にしじま	西嶋	姓	
にしじまかずひこ	西島一彦	人名	
にしじまゆかり	西嶋ゆかり	人名	
にしはら	西原	姓	
にしはらじゅん	西原純	人名	
にしやま	西山	姓	
にしやまあみ	西山あみ	人名	
にひら	仁平	姓	
にひらのぶあき	仁平宣明	人名	
のがた	野方	姓	
のがたゆうすけ	野方祐介	人名	
のぶあき	宣明	人名	
のぶお	信夫	人名	
のぶすけ	暢介	人名	
のむら	野村	姓	
のむらたかし	野村駿	人名	
のりお	則夫	人名	
のりやす	慎泰	人名	
はすぬま	蓮沼	姓	
はすぬまゆうき	蓮沼友樹	人名	
はた	羽田	姓	
はたはつき	羽田龍生	人名	
はつき	龍生	人名	
はった	八田	姓	
はったこうき	八田倖輝	人名	
はな	波奈	姓	
はなおか	花岡	姓	
はなおかあきお	花岡章生	人名	
はなみさと	波奈美里	人名	
はまがみ	浜上	姓	
はまがみぶんご	浜上文吾	人名	
はまの	浜野	姓	
はまのたいよう	浜野太陽	人名	
はやかわ	早川	姓	
はやかわけんた	早川健太	人名	
はやかわりんか	早川林香	人名	
はやし	林	姓	
はやしじゅんいちろう	林潤一郎	人名	
はやしとしひろ	林俊宏	人名	
はやしまさと	林雅人	人名	
はやと	颯斗	人名	
はやと	勇人	人名	
はやま	羽山	姓	
はやままこと	羽山真生	人名	
はら	原	姓	
はらゆうすけ	原佑典	人名	
はるか	遥	人名	
はるなり	春成	人名	
はるのぶ	晴信	人名	
ひいらぎ	柊木	姓	
ひいらぎかえで	柊木かえで	人名	
ひがしたに	東谷	姓	
ひがしたにたつや	東谷達矢	人名	
ひかる	ヒカル	人名	
ひぐち	樋口	姓	
ひぐちてつ	樋口徹	人名	
ひぐちようすけ	樋口洋輔	人名	
ひさし	久志	人名	
ひさと	寿人	人名	
ひさはる	久春	人名	
ひさふみ	寿文	人名	
ひさやま	久山	姓	
ひさやまこうじ	久山浩司	人名	
ひだか	日高	姓	
ひだかしほ	日高志穂	人名	
ひでき	秀樹	人名	
ひでただ	英忠	人名	
ひでゆき	秀幸	人名	
ひとつい	一井	姓	
ひとついしんや	一井慎也	人名	
ひなほ	雛歩	人名	
ひめこ	姫子	人名	
ひよし	日吉	姓	
ひよしたつや	日吉辰哉	人名	
ぴょんさん	秉参	人名	
ひらおか	平岡	姓	
ひらおかりえ	平岡理恵	人名	
ひらの	平野	姓	
ひらのけいご	平野敬悟	人名	
ひらのりょうえい	平野良栄	人名	
ひろあき	宏明	人名	
ひろえ	千瑛	人名	
ひろこ	寛子	人名	
ひろし	洋志	人名	
ひろし	弘	人名	
ひろしばた	HIRO柴田	人名	
ひろしばた	HIRO柴田	姓	
ひろつぐ	弘次	人名	
ひろとし	ヒロトシ	人名	
ひろのぶ	広宣	人名	
ひろのぶ	広信	人名	
ひろぶみ	宏文	人名	
ひろゆき	紘征	人名	
ひろゆき	浩之	人名	
ひろよし	大元	人名	
ふくしま	福島	姓	
ふくしまゆういち	福島佑一	人名	
ふくだ	福田	姓	
ふくだゆうた	福田雄大	人名	
ふくみつ	福光	姓	
ふくみつまさお	福光聖雄	人名	
ふくやま	福山	姓	
ふくやまみつゆき	福山満幸	人名	
ふじい	藤井	姓	
ふじいすみれ	藤井すみれ	人名	
ふじいたかのり	藤井崇勝	人名	
ふじお	不二夫	人名	
ふじおか	藤岡	姓	
ふじおかりょういち	藤岡良一	人名	
ふじさき	藤崎	姓	
ふじさきさとし	藤崎智	人名	
ふじさわ	藤沢	姓	
ふじさわはるのぶ	藤沢晴信	人名	
ふじしま	藤島	姓	
ふじしまけんじろう	藤島健二郎	人名	
ふじなが	藤永	姓	
ふじながりゅうま	藤永流馬	人名	
ふしみ	伏見	姓	
ふしみせいいちろう	伏見誠一郎	人名	
ふじもと	藤本	姓	
ふじもとしゅうじ	藤本修二	人名	
ふじもとてつや	藤本哲也	人名	
ふじもとてつや	藤本鉄也	人名	
ふじわら	藤原	姓	
ふじわらたかひろ	藤原隆弘	人名	
ふじわらまさのぶ	藤原正允	人名	
ふなき	船木	姓	
ふなきしんいち	船木伸一	人名	
ふみたか	郁孝	人名	
ふみたか	史孝	人名	
ふみや	文也	人名	
ふみや	文哉	人名	
ふみや	史哉	人名	
ふもと	麓	姓	
ふもとゆきお	麓征生	人名	
ふゆき	冬樹	人名	
ふるかわ	古川	姓	
ふるかわあやの	古川彩乃	人名	
ふるかわこうじ	古川孝次	人名	
ふるたに	古谷	姓	
ふるたにともみ	古谷知美	人名	
ふるはし	古橋	姓	
ふるはしたかし	古橋崇志	人名	
ふるもと	古本	姓	
ふるもとかずひろ	古本和宏	人名	
ぶんご	文吾	人名	
ぶんた	文太	人名	
ほうじょう	北條	姓	
ほうじょうえみ	北條恵美	人名	
ほさか	保坂	姓	
ほさかまりり	保坂麻璃莉	人名	
ほんだ	本田	姓	
ほんだともひろ	本田朋広	人名	
まいこ	麻衣子	人名	
まいこ	舞子	人名	
まえだ	前田	姓	
まえだなおや	前田直哉	人名	
まえはら	前原	姓	
まえはらゆうだい	前原雄大	人名	
まこ	真子	人名	
まこと	誠	人名	
まこと	真生	人名	
まこと	真功	人名	
まさあき	正明	人名	
まさあき	昌明	人名	
まさお	真生	人名	
まさお	聖雄	人名	
まさかず	正和	人名	
まさき	昌樹	人名	
まさき	誠輝	人名	
まさき	正樹	人名	
まさし	正志	人名	
まさし	雅	人名	
まさと	真人	人名	
まさと	雅人	人名	
まさと	剛任	人名	
まさとし	雅峻	人名	
まさとし	政俊	人名	
まさとし	真寿	人名	
まさのぶ	正允	人名	
まさはる	雅晴	人名	
まさはる	勝晴	人名	
まさひと	正仁	人名	
まさひろ	正裕	人名	
まさひろ	昌浩	人名	
まさや	雅也	人名	
まさゆき	将之	人名	
まさゆき	誠之	人名	
まさよし	正義	人名	
ますだ	増田	姓	
ますだりゅういち	増田隆一	人名	
まちだ	町田	姓	
まちだしおり	町田志織	人名	
まつおか	松岡	姓	
まつおかあきひこ	松岡昭彦	人名	
まつおかちあき	松岡千晶	人名	
まつざき	松崎	姓	
まつざきよしふみ	松崎良文	人名	
まつだ	松田	姓	
まつだあやか	松田彩花	人名	
まつもと	松本	姓	
まつもとしゅん	松本峻	人名	
まつもとゆうすけ	松本遊助	人名	
まつもとゆうや	松本裕也	人名	
まなぶ	学武	人名	
まなべ	真鍋	姓	
まなべあきひろ	真鍋明広	人名	
まりな	麻里菜	人名	
まりり	麻瑠莉	人名	
みうら	三浦	姓	
みうらだいすけ	三浦大輔	人名	
みうらともひろ	三浦智博	人名	
みお	美晤	人名	
みお	美晤	姓	
みお	美緒	人名	
みか	ミカ	人名	
みさき	美咲	姓	
みさきゆうな	美咲優菜	人名	
みさと	美里	人名	
みずぐち	水口	姓	
みずぐちりょう	水口崚	人名	
みずこし	水越	姓	
みずこしきょうこ	水越京子	人名	
みずさわ	水澤	姓	
みずさわあきひこ	水澤明彦	人名	
みた	三田	姓	
みたしんや	三田晋也	人名	
みたふじお	三田不二夫	人名	
みつてる	光輝	人名	
みつのり	光則	人名	
みつゆき	満幸	人名	
みと	三戸	姓	
みどり	翠	人名	
みとりょうすけ	三戸亮祐	人名	
みながわ	皆川	姓	
みながわなおき	皆川直毅	人名	
みながわゆうすけ	皆川侑亮	人名	
みなこ	美奈子	人名	
みなみ	美波	姓	
みなみともこ	美波智子	人名	
みのり	美乃里	人名	
みやうち	宮内	姓	
みやうちこずえ	宮内こずえ	人名	
みやざき	宮崎	姓	
みやざきこうのすけ	宮崎皓之介	人名	
みやざわ	宮澤	姓	
みやざわだいすけ	宮澤太佑	人名	
みやた	宮田	姓	
みやたまさや	宮田雅也	人名	
みやむら	宮村	姓	
みやむらしん	宮村信	人名	
みりま	美里麻	人名	
みりま	美里麻	姓	
むなかた	宗像	姓	
むなかたあつし	宗像惇	人名	
もとき	基輝	人名	
もとむ	求	人名	
もりおか	森岡	姓	
もりおかさだみ	森岡貞臣	人名	
もりした	森下	姓	
もりしたまさと	森下剛任	人名	
もりわき	森脇	姓	
もりわきつばさ	森脇翼	人名	
もれの	モレノ	人名	
やすだ	安田	姓	
やすだまりな	安田麻里菜	人名	
やすのぶ	康申	人名	
やすひで	泰秀	人名	
やすむら	安村	姓	
やすむらこうじ	安村浩司	人名	
やすゆき	泰之	人名	
やすらおか	安良岡	姓	
やすらおかまこと	安良岡真功	人名	
やまい	山井	姓	
やまいひろし	山井弘	人名	
やまこし	山腰	姓	
やまこしゆうき	山腰勇樹	人名	
やまざき	山嵜	姓	
やまざきたつまる	山嵜竜丸	人名	
やまだ	山田	姓	
やまだひろゆき	山田浩之	人名	
やまだまなぶ	山田学武	人名	
やまと	大和	人名	
やまと	大和	姓	
やまわき	山脇	姓	
やまわきちふみ	山脇千文美	人名	
ゆい	唯	人名	
ゆう	遊	人名	
ゆういち	佑一	人名	
ゆうき	優輝	人名	
ゆうき	裕貴	人名	
ゆうき	勇輝	人名	
ゆうき	佑貴	人名	
ゆうき	裕希	人名	
ゆうき	友樹	人名	
ゆうき	勇樹	人名	
ゆうこう	優孝	人名	
ゆうじ	佑ニ	人名	
ゆうすけ	悠介	人名	
ゆうすけ	優介	人名	
ゆうすけ	祐介	人名	
ゆうすけ	雄介	人名	
ゆうすけ	優佑	人名	
ゆうすけ	佑典	人名	
ゆうすけ	遊助	人名	
ゆうすけ	侑亮	人名	
ゆうせい	祐生	人名	
ゆうた	雄大	人名	
ゆうだい	雄大	人名	
ゆうと	裕斗	人名	
ゆうな	優菜	人名	
ゆうま	勇馬	人名	
ゆうみ	侑未	人名	
ゆうや	裕也	人名	
ゆかり	由佳梨	人名	
ゆき	侑希	人名	
ゆきお	征生	人名	
ゆきこ	由希子	人名	
ゆきのり	幸則	人名	
ゆづき	優月	姓	
ゆづきみか	優月みか	人名	
ゆのき	柚木	姓	
ゆのきまさひと	柚木正仁	人名	
ゆみ	由実	人名	
ゆり	由梨	人名	
ようすけ	陽介	人名	
ようすけ	洋輔	人名	
よしかず	吉和	人名	
よしき	義基	人名	
よしざわ	吉沢	姓	
よしざわ	吉澤	姓	
よしざわこうじ	吉沢康次	人名	
よしざわりゅうや	吉澤竜也	人名	
よしだ	吉田	姓	
よしたか	吉高	姓	
よしたかしょうご	吉高正悟	人名	
よしだただし	吉田直	人名	
よしだもとむ	吉田求	人名	
よしの	吉野	姓	
よしのあつし	吉野敦志	人名	
よしふみ	良文	人名	
らいと	来斗	人名	
らん	蘭	人名	
りえ	理絵	人名	
りえ	理恵	人名	
りさ	里咲	人名	
りさ	梨沙	人名	
りせ	梨世	人名	
りゅういち	隆市	人名	
りゅういち	隆一	人名	
りゅうすけ	竜介	人名	
りゅうま	流馬	人名	
りゅうや	竜也	人名	
りょう	遼	人名	
りょう	稜	人名	
りょう	諒	人名	
りょう	崚	人名	
りょういち	良一	人名	
りょうえい	良栄	人名	
りょうが	亮雅	人名	
りょうすけ	良介	人名	
りょうすけ	亮祐	人名	
りょうた	伶太	人名	
りょうた	亮多	人名	
りょうた	涼太	人名	
りょうた	瞭太	人名	
りょうた	諒汰	人名	
りん	凛	人名	
りんか	林香	人名	
るみ	瑠美	人名	
わくつ	和久津	姓	
わくつあきら	和久津晶	人名	
わたなべ	渡邉	姓	
わたなべ	渡辺	姓	
わたなべこうしろう	渡邉浩史郎	人名	
わたなべはやと	渡辺勇人	人名	
わたなべふみや	渡辺史哉	人名	
わたる	渉	人名	
わん	王	姓	
わんじぇんふぁん	王政芳	人名	